32,22
4,4,4,1,1,1,5,5,5,5,5,1,1,1,1,1,1,1,4,4,4,4,
4,4,4,4,1,1,6,6,1,1,5,5,5,1,1,1,1,1,1,4,4,4,
4,4,4,4,1,1,1,1,6,6,5,5,5,5,1,1,1,1,1,1,1,4,
1,4,4,4,4,1,1,1,5,5,5,5,5,5,1,1,1,5,5,1,1,1,
1,1,1,4,4,1,1,5,5,5,5,5,5,5,5,1,7,1,5,5,5,1,
8,8,8,8,1,4,1,1,1,5,5,5,5,5,5,5,1,5,5,5,1,1,
5,5,8,8,1,1,1,1,7,1,5,5,5,5,5,5,5,5,5,5,1,1,
5,5,5,8,8,8,1,1,1,1,1,1,5,5,5,5,5,5,5,1,1,1,
5,5,5,5,5,8,8,8,1,7,7,1,1,5,5,5,5,5,1,1,1,1,
5,5,5,5,5,1,1,1,1,1,1,1,1,8,5,5,5,5,1,1,1,7,
5,5,5,5,1,1,1,1,1,1,1,1,1,1,1,1,1,1,1,1,7,7,
5,5,1,1,1,1,5,5,8,8,6,6,1,1,1,1,1,1,1,1,7,7,
1,1,1,5,5,5,5,5,5,8,1,6,7,1,8,8,5,5,5,5,1,1,
5,1,1,1,1,5,5,5,5,8,1,1,2,2,1,8,8,5,5,5,5,5,
5,5,1,1,1,1,5,5,5,5,5,1,1,2,1,1,8,5,5,5,5,5,
5,5,5,8,8,1,1,5,5,5,5,5,5,1,7,8,8,5,5,5,5,5,
5,5,8,8,4,4,2,5,5,5,5,5,1,1,1,1,8,8,5,5,5,5,
5,5,8,1,4,4,4,1,5,5,5,5,5,5,5,1,1,1,5,5,5,5,
5,5,5,1,1,1,5,5,5,5,5,5,5,5,5,10,1,5,5,5,5,5,
5,5,5,5,5,5,5,5,5,5,5,5,5,5,5,1,1,1,1,5,5,5,
5,5,5,5,5,5,2,1,1,5,5,5,5,5,1,1,9,1,5,5,5,5,
5,5,5,5,5,5,1,7,1,2,5,5,5,5,5,1,2,1,1,1,5,5,
5,5,5,5,5,1,4,4,1,5,5,5,5,5,1,1,1,1,1,5,5,5,
5,5,5,1,1,4,4,1,2,1,1,1,5,5,1,7,2,1,5,5,5,5,
5,5,5,5,5,1,1,1,1,1,1,1,1,1,1,1,1,1,1,5,5,5,
5,5,5,5,5,5,5,1,1,1,1,1,1,2,2,1,1,1,5,5,5,5,
5,5,5,5,5,5,5,5,1,1,1,2,1,1,1,1,1,1,1,1,1,1,
5,5,5,5,1,1,1,1,1,5,1,1,1,1,6,6,1,1,1,1,1,1,
5,5,5,5,5,5,5,5,5,5,5,1,1,1,6,1,1,1,1,1,1,1,
5,5,5,5,5,5,5,5,4,1,1,1,1,1,1,6,1,1,1,1,1,4,
5,5,5,1,1,1,1,1,1,1,1,1,1,6,1,1,1,1,1,1,4,4,
5,5,5,5,5,1,1,1,1,4,4,4,1,6,6,1,1,1,4,4,4,4,
